Sequence	smiles
AA	C[C@H](N)C(=O)N[C@@H](C)C(=O)O
AG	C[C@H](N)C(=O)NCC(=O)O
AI	CC[C@H](C)[C@H](NC(=O)[C@H](C)N)C(=O)O
AL	CC(C)C[C@H](NC(=O)[C@H](C)N)C(=O)O
AP	C[C@H](N)C(=O)N1CCC[C@H]1C(=O)O
AV	CC(C)[C@H](NC(=O)[C@H](C)N)C(=O)O
AF	C[C@H](N)C(=O)N[C@@H](Cc1ccccc1)C(=O)O
AW	C[C@H](N)C(=O)N[C@@H](Cc1c[nH]c2ccccc12)C(=O)O
AY	C[C@H](N)C(=O)N[C@@H](Cc1ccc(O)cc1)C(=O)O
AD	C[C@H](N)C(=O)N[C@@H](CC(=O)O)C(=O)O
AE	C[C@H](N)C(=O)N[C@@H](CCC(=O)O)C(=O)O
AR	C[C@H](N)C(=O)N[C@@H](CCCNC(=N)N)C(=O)O
AH	C[C@H](N)C(=O)N[C@@H](Cc1c[nH]cn1)C(=O)O
AK	C[C@H](N)C(=O)N[C@@H](CCCCN)C(=O)O
AS	C[C@H](N)C(=O)N[C@@H](CO)C(=O)O
AT	C[C@H](N)C(=O)N[C@H](C(=O)O)[C@@H](C)O
AC	C[C@H](N)C(=O)N[C@@H](CS)C(=O)O
AM	CSCC[C@H](NC(=O)[C@H](C)N)C(=O)O
AN	C[C@H](N)C(=O)N[C@@H](CC(N)=O)C(=O)O
AQ	C[C@H](N)C(=O)N[C@@H](CCC(N)=O)C(=O)O
GA	C[C@H](NC(=O)CN)C(=O)O
GG	NCC(=O)NCC(=O)O
GI	CC[C@H](C)[C@H](NC(=O)CN)C(=O)O
GL	CC(C)C[C@H](NC(=O)CN)C(=O)O
GP	NCC(=O)N1CCC[C@H]1C(=O)O
GV	CC(C)[C@H](NC(=O)CN)C(=O)O
GF	NCC(=O)N[C@@H](Cc1ccccc1)C(=O)O
GW	NCC(=O)N[C@@H](Cc1c[nH]c2ccccc12)C(=O)O
GY	NCC(=O)N[C@@H](Cc1ccc(O)cc1)C(=O)O
GD	NCC(=O)N[C@@H](CC(=O)O)C(=O)O
GE	NCC(=O)N[C@@H](CCC(=O)O)C(=O)O
GR	N=C(N)NCCC[C@H](NC(=O)CN)C(=O)O
GH	NCC(=O)N[C@@H](Cc1c[nH]cn1)C(=O)O
GK	NCCCC[C@H](NC(=O)CN)C(=O)O
GS	NCC(=O)N[C@@H](CO)C(=O)O
GT	C[C@@H](O)[C@H](NC(=O)CN)C(=O)O
GC	NCC(=O)N[C@@H](CS)C(=O)O
GM	CSCC[C@H](NC(=O)CN)C(=O)O
GN	NCC(=O)N[C@@H](CC(N)=O)C(=O)O
GQ	NCC(=O)N[C@@H](CCC(N)=O)C(=O)O
IA	CC[C@H](C)[C@H](N)C(=O)N[C@@H](C)C(=O)O
IG	CC[C@H](C)[C@H](N)C(=O)NCC(=O)O
II	CC[C@H](C)[C@H](N)C(=O)N[C@H](C(=O)O)[C@@H](C)CC
IL	CC[C@H](C)[C@H](N)C(=O)N[C@@H](CC(C)C)C(=O)O
IP	CC[C@H](C)[C@H](N)C(=O)N1CCC[C@H]1C(=O)O
IV	CC[C@H](C)[C@H](N)C(=O)N[C@H](C(=O)O)C(C)C
IF	CC[C@H](C)[C@H](N)C(=O)N[C@@H](Cc1ccccc1)C(=O)O
IW	CC[C@H](C)[C@H](N)C(=O)N[C@@H](Cc1c[nH]c2ccccc12)C(=O)O
IY	CC[C@H](C)[C@H](N)C(=O)N[C@@H](Cc1ccc(O)cc1)C(=O)O
ID	CC[C@H](C)[C@H](N)C(=O)N[C@@H](CC(=O)O)C(=O)O
IE	CC[C@H](C)[C@H](N)C(=O)N[C@@H](CCC(=O)O)C(=O)O
IR	CC[C@H](C)[C@H](N)C(=O)N[C@@H](CCCNC(=N)N)C(=O)O
IH	CC[C@H](C)[C@H](N)C(=O)N[C@@H](Cc1c[nH]cn1)C(=O)O
IK	CC[C@H](C)[C@H](N)C(=O)N[C@@H](CCCCN)C(=O)O
IS	CC[C@H](C)[C@H](N)C(=O)N[C@@H](CO)C(=O)O
IT	CC[C@H](C)[C@H](N)C(=O)N[C@H](C(=O)O)[C@@H](C)O
IC	CC[C@H](C)[C@H](N)C(=O)N[C@@H](CS)C(=O)O
IM	CC[C@H](C)[C@H](N)C(=O)N[C@@H](CCSC)C(=O)O
IN	CC[C@H](C)[C@H](N)C(=O)N[C@@H](CC(N)=O)C(=O)O
IQ	CC[C@H](C)[C@H](N)C(=O)N[C@@H](CCC(N)=O)C(=O)O
LA	CC(C)C[C@H](N)C(=O)N[C@@H](C)C(=O)O
LG	CC(C)C[C@H](N)C(=O)NCC(=O)O
LI	CC[C@H](C)[C@H](NC(=O)[C@@H](N)CC(C)C)C(=O)O
LL	CC(C)C[C@H](N)C(=O)N[C@@H](CC(C)C)C(=O)O
LP	CC(C)C[C@H](N)C(=O)N1CCC[C@H]1C(=O)O
LV	CC(C)C[C@H](N)C(=O)N[C@H](C(=O)O)C(C)C
LF	CC(C)C[C@H](N)C(=O)N[C@@H](Cc1ccccc1)C(=O)O
LW	CC(C)C[C@H](N)C(=O)N[C@@H](Cc1c[nH]c2ccccc12)C(=O)O
LY	CC(C)C[C@H](N)C(=O)N[C@@H](Cc1ccc(O)cc1)C(=O)O
LD	CC(C)C[C@H](N)C(=O)N[C@@H](CC(=O)O)C(=O)O
LE	CC(C)C[C@H](N)C(=O)N[C@@H](CCC(=O)O)C(=O)O
LR	CC(C)C[C@H](N)C(=O)N[C@@H](CCCNC(=N)N)C(=O)O
LH	CC(C)C[C@H](N)C(=O)N[C@@H](Cc1c[nH]cn1)C(=O)O
LK	CC(C)C[C@H](N)C(=O)N[C@@H](CCCCN)C(=O)O
LS	CC(C)C[C@H](N)C(=O)N[C@@H](CO)C(=O)O
LT	CC(C)C[C@H](N)C(=O)N[C@H](C(=O)O)[C@@H](C)O
LC	CC(C)C[C@H](N)C(=O)N[C@@H](CS)C(=O)O
LM	CSCC[C@H](NC(=O)[C@@H](N)CC(C)C)C(=O)O
LN	CC(C)C[C@H](N)C(=O)N[C@@H](CC(N)=O)C(=O)O
LQ	CC(C)C[C@H](N)C(=O)N[C@@H](CCC(N)=O)C(=O)O
PA	C[C@H](NC(=O)[C@@H]1CCCN1)C(=O)O
PG	O=C(O)CNC(=O)[C@@H]1CCCN1
PI	CC[C@H](C)[C@H](NC(=O)[C@@H]1CCCN1)C(=O)O
PL	CC(C)C[C@H](NC(=O)[C@@H]1CCCN1)C(=O)O
PP	O=C(O)[C@@H]1CCCN1C(=O)[C@@H]1CCCN1
PV	CC(C)[C@H](NC(=O)[C@@H]1CCCN1)C(=O)O
PF	O=C(O)[C@H](Cc1ccccc1)NC(=O)[C@@H]1CCCN1
PW	O=C(O)[C@H](Cc1c[nH]c2ccccc12)NC(=O)[C@@H]1CCCN1
PY	O=C(O)[C@H](Cc1ccc(O)cc1)NC(=O)[C@@H]1CCCN1
PD	O=C(O)C[C@H](NC(=O)[C@@H]1CCCN1)C(=O)O
PE	O=C(O)CC[C@H](NC(=O)[C@@H]1CCCN1)C(=O)O
PR	N=C(N)NCCC[C@H](NC(=O)[C@@H]1CCCN1)C(=O)O
PH	O=C(O)[C@H](Cc1c[nH]cn1)NC(=O)[C@@H]1CCCN1
PK	NCCCC[C@H](NC(=O)[C@@H]1CCCN1)C(=O)O
PS	O=C(O)[C@H](CO)NC(=O)[C@@H]1CCCN1
PT	C[C@@H](O)[C@H](NC(=O)[C@@H]1CCCN1)C(=O)O
PC	O=C(N[C@@H](CS)C(=O)O)[C@@H]1CCCN1
PM	CSCC[C@H](NC(=O)[C@@H]1CCCN1)C(=O)O
PN	NC(=O)C[C@H](NC(=O)[C@@H]1CCCN1)C(=O)O
PQ	NC(=O)CC[C@H](NC(=O)[C@@H]1CCCN1)C(=O)O
VA	CC(C)[C@H](N)C(=O)N[C@@H](C)C(=O)O
VG	CC(C)[C@H](N)C(=O)NCC(=O)O
VI	CC[C@H](C)[C@H](NC(=O)[C@@H](N)C(C)C)C(=O)O
VL	CC(C)C[C@H](NC(=O)[C@@H](N)C(C)C)C(=O)O
VP	CC(C)[C@H](N)C(=O)N1CCC[C@H]1C(=O)O
VV	CC(C)[C@H](N)C(=O)N[C@H](C(=O)O)C(C)C
VF	CC(C)[C@H](N)C(=O)N[C@@H](Cc1ccccc1)C(=O)O
VW	CC(C)[C@H](N)C(=O)N[C@@H](Cc1c[nH]c2ccccc12)C(=O)O
VY	CC(C)[C@H](N)C(=O)N[C@@H](Cc1ccc(O)cc1)C(=O)O
VD	CC(C)[C@H](N)C(=O)N[C@@H](CC(=O)O)C(=O)O
VE	CC(C)[C@H](N)C(=O)N[C@@H](CCC(=O)O)C(=O)O
VR	CC(C)[C@H](N)C(=O)N[C@@H](CCCNC(=N)N)C(=O)O
VH	CC(C)[C@H](N)C(=O)N[C@@H](Cc1c[nH]cn1)C(=O)O
VK	CC(C)[C@H](N)C(=O)N[C@@H](CCCCN)C(=O)O
VS	CC(C)[C@H](N)C(=O)N[C@@H](CO)C(=O)O
VT	CC(C)[C@H](N)C(=O)N[C@H](C(=O)O)[C@@H](C)O
VC	CC(C)[C@H](N)C(=O)N[C@@H](CS)C(=O)O
VM	CSCC[C@H](NC(=O)[C@@H](N)C(C)C)C(=O)O
VN	CC(C)[C@H](N)C(=O)N[C@@H](CC(N)=O)C(=O)O
VQ	CC(C)[C@H](N)C(=O)N[C@@H](CCC(N)=O)C(=O)O
FA	C[C@H](NC(=O)[C@@H](N)Cc1ccccc1)C(=O)O
FG	N[C@@H](Cc1ccccc1)C(=O)NCC(=O)O
FI	CC[C@H](C)[C@H](NC(=O)[C@@H](N)Cc1ccccc1)C(=O)O
FL	CC(C)C[C@H](NC(=O)[C@@H](N)Cc1ccccc1)C(=O)O
FP	N[C@@H](Cc1ccccc1)C(=O)N1CCC[C@H]1C(=O)O
FV	CC(C)[C@H](NC(=O)[C@@H](N)Cc1ccccc1)C(=O)O
FF	N[C@@H](Cc1ccccc1)C(=O)N[C@@H](Cc1ccccc1)C(=O)O
FW	N[C@@H](Cc1ccccc1)C(=O)N[C@@H](Cc1c[nH]c2ccccc12)C(=O)O
FY	N[C@@H](Cc1ccccc1)C(=O)N[C@@H](Cc1ccc(O)cc1)C(=O)O
FD	N[C@@H](Cc1ccccc1)C(=O)N[C@@H](CC(=O)O)C(=O)O
FE	N[C@@H](Cc1ccccc1)C(=O)N[C@@H](CCC(=O)O)C(=O)O
FR	N=C(N)NCCC[C@H](NC(=O)[C@@H](N)Cc1ccccc1)C(=O)O
FH	N[C@@H](Cc1ccccc1)C(=O)N[C@@H](Cc1c[nH]cn1)C(=O)O
FK	NCCCC[C@H](NC(=O)[C@@H](N)Cc1ccccc1)C(=O)O
FS	N[C@@H](Cc1ccccc1)C(=O)N[C@@H](CO)C(=O)O
FT	C[C@@H](O)[C@H](NC(=O)[C@@H](N)Cc1ccccc1)C(=O)O
FC	N[C@@H](Cc1ccccc1)C(=O)N[C@@H](CS)C(=O)O
FM	CSCC[C@H](NC(=O)[C@@H](N)Cc1ccccc1)C(=O)O
FN	NC(=O)C[C@H](NC(=O)[C@@H](N)Cc1ccccc1)C(=O)O
FQ	NC(=O)CC[C@H](NC(=O)[C@@H](N)Cc1ccccc1)C(=O)O
WA	C[C@H](NC(=O)[C@@H](N)Cc1c[nH]c2ccccc12)C(=O)O
WG	N[C@@H](Cc1c[nH]c2ccccc12)C(=O)NCC(=O)O
WI	CC[C@H](C)[C@H](NC(=O)[C@@H](N)Cc1c[nH]c2ccccc12)C(=O)O
WL	CC(C)C[C@H](NC(=O)[C@@H](N)Cc1c[nH]c2ccccc12)C(=O)O
WP	N[C@@H](Cc1c[nH]c2ccccc12)C(=O)N1CCC[C@H]1C(=O)O
WV	CC(C)[C@H](NC(=O)[C@@H](N)Cc1c[nH]c2ccccc12)C(=O)O
WF	N[C@@H](Cc1c[nH]c2ccccc12)C(=O)N[C@@H](Cc1ccccc1)C(=O)O
WW	N[C@@H](Cc1c[nH]c2ccccc12)C(=O)N[C@@H](Cc1c[nH]c2ccccc12)C(=O)O
WY	N[C@@H](Cc1c[nH]c2ccccc12)C(=O)N[C@@H](Cc1ccc(O)cc1)C(=O)O
WD	N[C@@H](Cc1c[nH]c2ccccc12)C(=O)N[C@@H](CC(=O)O)C(=O)O
WE	N[C@@H](Cc1c[nH]c2ccccc12)C(=O)N[C@@H](CCC(=O)O)C(=O)O
WR	N=C(N)NCCC[C@H](NC(=O)[C@@H](N)Cc1c[nH]c2ccccc12)C(=O)O
WH	N[C@@H](Cc1c[nH]c2ccccc12)C(=O)N[C@@H](Cc1c[nH]cn1)C(=O)O
WK	NCCCC[C@H](NC(=O)[C@@H](N)Cc1c[nH]c2ccccc12)C(=O)O
WS	N[C@@H](Cc1c[nH]c2ccccc12)C(=O)N[C@@H](CO)C(=O)O
WT	C[C@@H](O)[C@H](NC(=O)[C@@H](N)Cc1c[nH]c2ccccc12)C(=O)O
WC	N[C@@H](Cc1c[nH]c2ccccc12)C(=O)N[C@@H](CS)C(=O)O
WM	CSCC[C@H](NC(=O)[C@@H](N)Cc1c[nH]c2ccccc12)C(=O)O
WN	NC(=O)C[C@H](NC(=O)[C@@H](N)Cc1c[nH]c2ccccc12)C(=O)O
WQ	NC(=O)CC[C@H](NC(=O)[C@@H](N)Cc1c[nH]c2ccccc12)C(=O)O
YA	C[C@H](NC(=O)[C@@H](N)Cc1ccc(O)cc1)C(=O)O
YG	N[C@@H](Cc1ccc(O)cc1)C(=O)NCC(=O)O
YI	CC[C@H](C)[C@H](NC(=O)[C@@H](N)Cc1ccc(O)cc1)C(=O)O
YL	CC(C)C[C@H](NC(=O)[C@@H](N)Cc1ccc(O)cc1)C(=O)O
YP	N[C@@H](Cc1ccc(O)cc1)C(=O)N1CCC[C@H]1C(=O)O
YV	CC(C)[C@H](NC(=O)[C@@H](N)Cc1ccc(O)cc1)C(=O)O
YF	N[C@@H](Cc1ccc(O)cc1)C(=O)N[C@@H](Cc1ccccc1)C(=O)O
YW	N[C@@H](Cc1ccc(O)cc1)C(=O)N[C@@H](Cc1c[nH]c2ccccc12)C(=O)O
YY	N[C@@H](Cc1ccc(O)cc1)C(=O)N[C@@H](Cc1ccc(O)cc1)C(=O)O
YD	N[C@@H](Cc1ccc(O)cc1)C(=O)N[C@@H](CC(=O)O)C(=O)O
YE	N[C@@H](Cc1ccc(O)cc1)C(=O)N[C@@H](CCC(=O)O)C(=O)O
YR	N=C(N)NCCC[C@H](NC(=O)[C@@H](N)Cc1ccc(O)cc1)C(=O)O
YH	N[C@@H](Cc1ccc(O)cc1)C(=O)N[C@@H](Cc1c[nH]cn1)C(=O)O
YK	NCCCC[C@H](NC(=O)[C@@H](N)Cc1ccc(O)cc1)C(=O)O
YS	N[C@@H](Cc1ccc(O)cc1)C(=O)N[C@@H](CO)C(=O)O
YT	C[C@@H](O)[C@H](NC(=O)[C@@H](N)Cc1ccc(O)cc1)C(=O)O
YC	N[C@@H](Cc1ccc(O)cc1)C(=O)N[C@@H](CS)C(=O)O
YM	CSCC[C@H](NC(=O)[C@@H](N)Cc1ccc(O)cc1)C(=O)O
YN	NC(=O)C[C@H](NC(=O)[C@@H](N)Cc1ccc(O)cc1)C(=O)O
YQ	NC(=O)CC[C@H](NC(=O)[C@@H](N)Cc1ccc(O)cc1)C(=O)O
DA	C[C@H](NC(=O)[C@@H](N)CC(=O)O)C(=O)O
DG	N[C@@H](CC(=O)O)C(=O)NCC(=O)O
DI	CC[C@H](C)[C@H](NC(=O)[C@@H](N)CC(=O)O)C(=O)O
DL	CC(C)C[C@H](NC(=O)[C@@H](N)CC(=O)O)C(=O)O
DP	N[C@@H](CC(=O)O)C(=O)N1CCC[C@H]1C(=O)O
DV	CC(C)[C@H](NC(=O)[C@@H](N)CC(=O)O)C(=O)O
DF	N[C@@H](CC(=O)O)C(=O)N[C@@H](Cc1ccccc1)C(=O)O
DW	N[C@@H](CC(=O)O)C(=O)N[C@@H](Cc1c[nH]c2ccccc12)C(=O)O
DY	N[C@@H](CC(=O)O)C(=O)N[C@@H](Cc1ccc(O)cc1)C(=O)O
DD	N[C@@H](CC(=O)O)C(=O)N[C@@H](CC(=O)O)C(=O)O
DE	N[C@@H](CC(=O)O)C(=O)N[C@@H](CCC(=O)O)C(=O)O
DR	N=C(N)NCCC[C@H](NC(=O)[C@@H](N)CC(=O)O)C(=O)O
DH	N[C@@H](CC(=O)O)C(=O)N[C@@H](Cc1c[nH]cn1)C(=O)O
DK	NCCCC[C@H](NC(=O)[C@@H](N)CC(=O)O)C(=O)O
DS	N[C@@H](CC(=O)O)C(=O)N[C@@H](CO)C(=O)O
DT	C[C@@H](O)[C@H](NC(=O)[C@@H](N)CC(=O)O)C(=O)O
DC	N[C@@H](CC(=O)O)C(=O)N[C@@H](CS)C(=O)O
DM	CSCC[C@H](NC(=O)[C@@H](N)CC(=O)O)C(=O)O
DN	NC(=O)C[C@H](NC(=O)[C@@H](N)CC(=O)O)C(=O)O
DQ	NC(=O)CC[C@H](NC(=O)[C@@H](N)CC(=O)O)C(=O)O
EA	C[C@H](NC(=O)[C@@H](N)CCC(=O)O)C(=O)O
EG	N[C@@H](CCC(=O)O)C(=O)NCC(=O)O
EI	CC[C@H](C)[C@H](NC(=O)[C@@H](N)CCC(=O)O)C(=O)O
EL	CC(C)C[C@H](NC(=O)[C@@H](N)CCC(=O)O)C(=O)O
EP	N[C@@H](CCC(=O)O)C(=O)N1CCC[C@H]1C(=O)O
EV	CC(C)[C@H](NC(=O)[C@@H](N)CCC(=O)O)C(=O)O
EF	N[C@@H](CCC(=O)O)C(=O)N[C@@H](Cc1ccccc1)C(=O)O
EW	N[C@@H](CCC(=O)O)C(=O)N[C@@H](Cc1c[nH]c2ccccc12)C(=O)O
EY	N[C@@H](CCC(=O)O)C(=O)N[C@@H](Cc1ccc(O)cc1)C(=O)O
ED	N[C@@H](CCC(=O)O)C(=O)N[C@@H](CC(=O)O)C(=O)O
EE	N[C@@H](CCC(=O)O)C(=O)N[C@@H](CCC(=O)O)C(=O)O
ER	N=C(N)NCCC[C@H](NC(=O)[C@@H](N)CCC(=O)O)C(=O)O
EH	N[C@@H](CCC(=O)O)C(=O)N[C@@H](Cc1c[nH]cn1)C(=O)O
EK	NCCCC[C@H](NC(=O)[C@@H](N)CCC(=O)O)C(=O)O
ES	N[C@@H](CCC(=O)O)C(=O)N[C@@H](CO)C(=O)O
ET	C[C@@H](O)[C@H](NC(=O)[C@@H](N)CCC(=O)O)C(=O)O
EC	N[C@@H](CCC(=O)O)C(=O)N[C@@H](CS)C(=O)O
EM	CSCC[C@H](NC(=O)[C@@H](N)CCC(=O)O)C(=O)O
EN	NC(=O)C[C@H](NC(=O)[C@@H](N)CCC(=O)O)C(=O)O
EQ	NC(=O)CC[C@H](NC(=O)[C@@H](N)CCC(=O)O)C(=O)O
RA	C[C@H](NC(=O)[C@@H](N)CCCNC(=N)N)C(=O)O
RG	N=C(N)NCCC[C@H](N)C(=O)NCC(=O)O
RI	CC[C@H](C)[C@H](NC(=O)[C@@H](N)CCCNC(=N)N)C(=O)O
RL	CC(C)C[C@H](NC(=O)[C@@H](N)CCCNC(=N)N)C(=O)O
RP	N=C(N)NCCC[C@H](N)C(=O)N1CCC[C@H]1C(=O)O
RV	CC(C)[C@H](NC(=O)[C@@H](N)CCCNC(=N)N)C(=O)O
RF	N=C(N)NCCC[C@H](N)C(=O)N[C@@H](Cc1ccccc1)C(=O)O
RW	N=C(N)NCCC[C@H](N)C(=O)N[C@@H](Cc1c[nH]c2ccccc12)C(=O)O
RY	N=C(N)NCCC[C@H](N)C(=O)N[C@@H](Cc1ccc(O)cc1)C(=O)O
RD	N=C(N)NCCC[C@H](N)C(=O)N[C@@H](CC(=O)O)C(=O)O
RE	N=C(N)NCCC[C@H](N)C(=O)N[C@@H](CCC(=O)O)C(=O)O
RR	N=C(N)NCCC[C@H](N)C(=O)N[C@@H](CCCNC(=N)N)C(=O)O
RH	N=C(N)NCCC[C@H](N)C(=O)N[C@@H](Cc1c[nH]cn1)C(=O)O
RK	N=C(N)NCCC[C@H](N)C(=O)N[C@@H](CCCCN)C(=O)O
RS	N=C(N)NCCC[C@H](N)C(=O)N[C@@H](CO)C(=O)O
RT	C[C@@H](O)[C@H](NC(=O)[C@@H](N)CCCNC(=N)N)C(=O)O
RC	N=C(N)NCCC[C@H](N)C(=O)N[C@@H](CS)C(=O)O
RM	CSCC[C@H](NC(=O)[C@@H](N)CCCNC(=N)N)C(=O)O
RN	N=C(N)NCCC[C@H](N)C(=O)N[C@@H](CC(N)=O)C(=O)O
RQ	N=C(N)NCCC[C@H](N)C(=O)N[C@@H](CCC(N)=O)C(=O)O
HA	C[C@H](NC(=O)[C@@H](N)Cc1c[nH]cn1)C(=O)O
HG	N[C@@H](Cc1c[nH]cn1)C(=O)NCC(=O)O
HI	CC[C@H](C)[C@H](NC(=O)[C@@H](N)Cc1c[nH]cn1)C(=O)O
HL	CC(C)C[C@H](NC(=O)[C@@H](N)Cc1c[nH]cn1)C(=O)O
HP	N[C@@H](Cc1c[nH]cn1)C(=O)N1CCC[C@H]1C(=O)O
HV	CC(C)[C@H](NC(=O)[C@@H](N)Cc1c[nH]cn1)C(=O)O
HF	N[C@@H](Cc1c[nH]cn1)C(=O)N[C@@H](Cc1ccccc1)C(=O)O
HW	N[C@@H](Cc1c[nH]cn1)C(=O)N[C@@H](Cc1c[nH]c2ccccc12)C(=O)O
HY	N[C@@H](Cc1c[nH]cn1)C(=O)N[C@@H](Cc1ccc(O)cc1)C(=O)O
HD	N[C@@H](Cc1c[nH]cn1)C(=O)N[C@@H](CC(=O)O)C(=O)O
HE	N[C@@H](Cc1c[nH]cn1)C(=O)N[C@@H](CCC(=O)O)C(=O)O
HR	N=C(N)NCCC[C@H](NC(=O)[C@@H](N)Cc1c[nH]cn1)C(=O)O
HH	N[C@@H](Cc1c[nH]cn1)C(=O)N[C@@H](Cc1c[nH]cn1)C(=O)O
HK	NCCCC[C@H](NC(=O)[C@@H](N)Cc1c[nH]cn1)C(=O)O
HS	N[C@@H](Cc1c[nH]cn1)C(=O)N[C@@H](CO)C(=O)O
HT	C[C@@H](O)[C@H](NC(=O)[C@@H](N)Cc1c[nH]cn1)C(=O)O
HC	N[C@@H](Cc1c[nH]cn1)C(=O)N[C@@H](CS)C(=O)O
HM	CSCC[C@H](NC(=O)[C@@H](N)Cc1c[nH]cn1)C(=O)O
HN	NC(=O)C[C@H](NC(=O)[C@@H](N)Cc1c[nH]cn1)C(=O)O
HQ	NC(=O)CC[C@H](NC(=O)[C@@H](N)Cc1c[nH]cn1)C(=O)O
KA	C[C@H](NC(=O)[C@@H](N)CCCCN)C(=O)O
KG	NCCCC[C@H](N)C(=O)NCC(=O)O
KI	CC[C@H](C)[C@H](NC(=O)[C@@H](N)CCCCN)C(=O)O
KL	CC(C)C[C@H](NC(=O)[C@@H](N)CCCCN)C(=O)O
KP	NCCCC[C@H](N)C(=O)N1CCC[C@H]1C(=O)O
KV	CC(C)[C@H](NC(=O)[C@@H](N)CCCCN)C(=O)O
KF	NCCCC[C@H](N)C(=O)N[C@@H](Cc1ccccc1)C(=O)O
KW	NCCCC[C@H](N)C(=O)N[C@@H](Cc1c[nH]c2ccccc12)C(=O)O
KY	NCCCC[C@H](N)C(=O)N[C@@H](Cc1ccc(O)cc1)C(=O)O
KD	NCCCC[C@H](N)C(=O)N[C@@H](CC(=O)O)C(=O)O
KE	NCCCC[C@H](N)C(=O)N[C@@H](CCC(=O)O)C(=O)O
KR	N=C(N)NCCC[C@H](NC(=O)[C@@H](N)CCCCN)C(=O)O
KH	NCCCC[C@H](N)C(=O)N[C@@H](Cc1c[nH]cn1)C(=O)O
KK	NCCCC[C@H](N)C(=O)N[C@@H](CCCCN)C(=O)O
KS	NCCCC[C@H](N)C(=O)N[C@@H](CO)C(=O)O
KT	C[C@@H](O)[C@H](NC(=O)[C@@H](N)CCCCN)C(=O)O
KC	NCCCC[C@H](N)C(=O)N[C@@H](CS)C(=O)O
KM	CSCC[C@H](NC(=O)[C@@H](N)CCCCN)C(=O)O
KN	NCCCC[C@H](N)C(=O)N[C@@H](CC(N)=O)C(=O)O
KQ	NCCCC[C@H](N)C(=O)N[C@@H](CCC(N)=O)C(=O)O
SA	C[C@H](NC(=O)[C@@H](N)CO)C(=O)O
SG	N[C@@H](CO)C(=O)NCC(=O)O
SI	CC[C@H](C)[C@H](NC(=O)[C@@H](N)CO)C(=O)O
SL	CC(C)C[C@H](NC(=O)[C@@H](N)CO)C(=O)O
SP	N[C@@H](CO)C(=O)N1CCC[C@H]1C(=O)O
SV	CC(C)[C@H](NC(=O)[C@@H](N)CO)C(=O)O
SF	N[C@@H](CO)C(=O)N[C@@H](Cc1ccccc1)C(=O)O
SW	N[C@@H](CO)C(=O)N[C@@H](Cc1c[nH]c2ccccc12)C(=O)O
SY	N[C@@H](CO)C(=O)N[C@@H](Cc1ccc(O)cc1)C(=O)O
SD	N[C@@H](CO)C(=O)N[C@@H](CC(=O)O)C(=O)O
SE	N[C@@H](CO)C(=O)N[C@@H](CCC(=O)O)C(=O)O
SR	N=C(N)NCCC[C@H](NC(=O)[C@@H](N)CO)C(=O)O
SH	N[C@@H](CO)C(=O)N[C@@H](Cc1c[nH]cn1)C(=O)O
SK	NCCCC[C@H](NC(=O)[C@@H](N)CO)C(=O)O
SS	N[C@@H](CO)C(=O)N[C@@H](CO)C(=O)O
ST	C[C@@H](O)[C@H](NC(=O)[C@@H](N)CO)C(=O)O
SC	N[C@@H](CO)C(=O)N[C@@H](CS)C(=O)O
SM	CSCC[C@H](NC(=O)[C@@H](N)CO)C(=O)O
SN	NC(=O)C[C@H](NC(=O)[C@@H](N)CO)C(=O)O
SQ	NC(=O)CC[C@H](NC(=O)[C@@H](N)CO)C(=O)O
TA	C[C@H](NC(=O)[C@@H](N)[C@@H](C)O)C(=O)O
TG	C[C@@H](O)[C@H](N)C(=O)NCC(=O)O
TI	CC[C@H](C)[C@H](NC(=O)[C@@H](N)[C@@H](C)O)C(=O)O
TL	CC(C)C[C@H](NC(=O)[C@@H](N)[C@@H](C)O)C(=O)O
TP	C[C@@H](O)[C@H](N)C(=O)N1CCC[C@H]1C(=O)O
TV	CC(C)[C@H](NC(=O)[C@@H](N)[C@@H](C)O)C(=O)O
TF	C[C@@H](O)[C@H](N)C(=O)N[C@@H](Cc1ccccc1)C(=O)O
TW	C[C@@H](O)[C@H](N)C(=O)N[C@@H](Cc1c[nH]c2ccccc12)C(=O)O
TY	C[C@@H](O)[C@H](N)C(=O)N[C@@H](Cc1ccc(O)cc1)C(=O)O
TD	C[C@@H](O)[C@H](N)C(=O)N[C@@H](CC(=O)O)C(=O)O
TE	C[C@@H](O)[C@H](N)C(=O)N[C@@H](CCC(=O)O)C(=O)O
TR	C[C@@H](O)[C@H](N)C(=O)N[C@@H](CCCNC(=N)N)C(=O)O
TH	C[C@@H](O)[C@H](N)C(=O)N[C@@H](Cc1c[nH]cn1)C(=O)O
TK	C[C@@H](O)[C@H](N)C(=O)N[C@@H](CCCCN)C(=O)O
TS	C[C@@H](O)[C@H](N)C(=O)N[C@@H](CO)C(=O)O
TT	C[C@@H](O)[C@H](N)C(=O)N[C@H](C(=O)O)[C@@H](C)O
TC	C[C@@H](O)[C@H](N)C(=O)N[C@@H](CS)C(=O)O
TM	CSCC[C@H](NC(=O)[C@@H](N)[C@@H](C)O)C(=O)O
TN	C[C@@H](O)[C@H](N)C(=O)N[C@@H](CC(N)=O)C(=O)O
TQ	C[C@@H](O)[C@H](N)C(=O)N[C@@H](CCC(N)=O)C(=O)O
CA	C[C@H](NC(=O)[C@@H](N)CS)C(=O)O
CG	N[C@@H](CS)C(=O)NCC(=O)O
CI	CC[C@H](C)[C@H](NC(=O)[C@@H](N)CS)C(=O)O
CL	CC(C)C[C@H](NC(=O)[C@@H](N)CS)C(=O)O
CP	N[C@@H](CS)C(=O)N1CCC[C@H]1C(=O)O
CV	CC(C)[C@H](NC(=O)[C@@H](N)CS)C(=O)O
CF	N[C@@H](CS)C(=O)N[C@@H](Cc1ccccc1)C(=O)O
CW	N[C@@H](CS)C(=O)N[C@@H](Cc1c[nH]c2ccccc12)C(=O)O
CY	N[C@@H](CS)C(=O)N[C@@H](Cc1ccc(O)cc1)C(=O)O
CD	N[C@@H](CS)C(=O)N[C@@H](CC(=O)O)C(=O)O
CE	N[C@@H](CS)C(=O)N[C@@H](CCC(=O)O)C(=O)O
CR	N=C(N)NCCC[C@H](NC(=O)[C@@H](N)CS)C(=O)O
CH	N[C@@H](CS)C(=O)N[C@@H](Cc1c[nH]cn1)C(=O)O
CK	NCCCC[C@H](NC(=O)[C@@H](N)CS)C(=O)O
CS	N[C@@H](CS)C(=O)N[C@@H](CO)C(=O)O
CT	C[C@@H](O)[C@H](NC(=O)[C@@H](N)CS)C(=O)O
CC	N[C@@H](CS)C(=O)N[C@@H](CS)C(=O)O
CM	CSCC[C@H](NC(=O)[C@@H](N)CS)C(=O)O
CN	NC(=O)C[C@H](NC(=O)[C@@H](N)CS)C(=O)O
CQ	NC(=O)CC[C@H](NC(=O)[C@@H](N)CS)C(=O)O
MA	CSCC[C@H](N)C(=O)N[C@@H](C)C(=O)O
MG	CSCC[C@H](N)C(=O)NCC(=O)O
MI	CC[C@H](C)[C@H](NC(=O)[C@@H](N)CCSC)C(=O)O
ML	CSCC[C@H](N)C(=O)N[C@@H](CC(C)C)C(=O)O
MP	CSCC[C@H](N)C(=O)N1CCC[C@H]1C(=O)O
MV	CSCC[C@H](N)C(=O)N[C@H](C(=O)O)C(C)C
MF	CSCC[C@H](N)C(=O)N[C@@H](Cc1ccccc1)C(=O)O
MW	CSCC[C@H](N)C(=O)N[C@@H](Cc1c[nH]c2ccccc12)C(=O)O
MY	CSCC[C@H](N)C(=O)N[C@@H](Cc1ccc(O)cc1)C(=O)O
MD	CSCC[C@H](N)C(=O)N[C@@H](CC(=O)O)C(=O)O
ME	CSCC[C@H](N)C(=O)N[C@@H](CCC(=O)O)C(=O)O
MR	CSCC[C@H](N)C(=O)N[C@@H](CCCNC(=N)N)C(=O)O
MH	CSCC[C@H](N)C(=O)N[C@@H](Cc1c[nH]cn1)C(=O)O
MK	CSCC[C@H](N)C(=O)N[C@@H](CCCCN)C(=O)O
MS	CSCC[C@H](N)C(=O)N[C@@H](CO)C(=O)O
MT	CSCC[C@H](N)C(=O)N[C@H](C(=O)O)[C@@H](C)O
MC	CSCC[C@H](N)C(=O)N[C@@H](CS)C(=O)O
MM	CSCC[C@H](N)C(=O)N[C@@H](CCSC)C(=O)O
MN	CSCC[C@H](N)C(=O)N[C@@H](CC(N)=O)C(=O)O
MQ	CSCC[C@H](N)C(=O)N[C@@H](CCC(N)=O)C(=O)O
nan	C[C@H](NC(=O)[C@@H](N)CC(N)=O)C(=O)N[C@@H](CC(N)=O)C(=O)O
NG	NC(=O)C[C@H](N)C(=O)NCC(=O)O
NI	CC[C@H](C)[C@H](NC(=O)[C@@H](N)CC(N)=O)C(=O)O
NL	CC(C)C[C@H](NC(=O)[C@@H](N)CC(N)=O)C(=O)O
NP	NC(=O)C[C@H](N)C(=O)N1CCC[C@H]1C(=O)O
NV	CC(C)[C@H](NC(=O)[C@@H](N)CC(N)=O)C(=O)O
NF	NC(=O)C[C@H](N)C(=O)N[C@@H](Cc1ccccc1)C(=O)O
NW	NC(=O)C[C@H](N)C(=O)N[C@@H](Cc1c[nH]c2ccccc12)C(=O)O
NY	NC(=O)C[C@H](N)C(=O)N[C@@H](Cc1ccc(O)cc1)C(=O)O
ND	NC(=O)C[C@H](N)C(=O)N[C@@H](CC(=O)O)C(=O)O
NE	NC(=O)C[C@H](N)C(=O)N[C@@H](CCC(=O)O)C(=O)O
NR	N=C(N)NCCC[C@H](NC(=O)[C@@H](N)CC(N)=O)C(=O)O
NH	NC(=O)C[C@H](N)C(=O)N[C@@H](Cc1c[nH]cn1)C(=O)O
NK	NCCCC[C@H](NC(=O)[C@@H](N)CC(N)=O)C(=O)O
NS	NC(=O)C[C@H](N)C(=O)N[C@@H](CO)C(=O)O
NT	C[C@@H](O)[C@H](NC(=O)[C@@H](N)CC(N)=O)C(=O)O
NC	NC(=O)C[C@H](N)C(=O)N[C@@H](CS)C(=O)O
NM	CSCC[C@H](NC(=O)[C@@H](N)CC(N)=O)C(=O)O
NN	NC(=O)C[C@H](N)C(=O)N[C@@H](CC(N)=O)C(=O)O
NQ	NC(=O)CC[C@H](NC(=O)[C@@H](N)CC(N)=O)C(=O)O
QA	C[C@H](NC(=O)[C@@H](N)CCC(N)=O)C(=O)O
QG	NC(=O)CC[C@H](N)C(=O)NCC(=O)O
QI	CC[C@H](C)[C@H](NC(=O)[C@@H](N)CCC(N)=O)C(=O)O
QL	CC(C)C[C@H](NC(=O)[C@@H](N)CCC(N)=O)C(=O)O
QP	NC(=O)CC[C@H](N)C(=O)N1CCC[C@H]1C(=O)O
QV	CC(C)[C@H](NC(=O)[C@@H](N)CCC(N)=O)C(=O)O
QF	NC(=O)CC[C@H](N)C(=O)N[C@@H](Cc1ccccc1)C(=O)O
QW	NC(=O)CC[C@H](N)C(=O)N[C@@H](Cc1c[nH]c2ccccc12)C(=O)O
QY	NC(=O)CC[C@H](N)C(=O)N[C@@H](Cc1ccc(O)cc1)C(=O)O
QD	NC(=O)CC[C@H](N)C(=O)N[C@@H](CC(=O)O)C(=O)O
QE	NC(=O)CC[C@H](N)C(=O)N[C@@H](CCC(=O)O)C(=O)O
QR	N=C(N)NCCC[C@H](NC(=O)[C@@H](N)CCC(N)=O)C(=O)O
QH	NC(=O)CC[C@H](N)C(=O)N[C@@H](Cc1c[nH]cn1)C(=O)O
QK	NCCCC[C@H](NC(=O)[C@@H](N)CCC(N)=O)C(=O)O
QS	NC(=O)CC[C@H](N)C(=O)N[C@@H](CO)C(=O)O
QT	C[C@@H](O)[C@H](NC(=O)[C@@H](N)CCC(N)=O)C(=O)O
QC	NC(=O)CC[C@H](N)C(=O)N[C@@H](CS)C(=O)O
QM	CSCC[C@H](NC(=O)[C@@H](N)CCC(N)=O)C(=O)O
QN	NC(=O)CC[C@H](N)C(=O)N[C@@H](CC(N)=O)C(=O)O
QQ	NC(=O)CC[C@H](N)C(=O)N[C@@H](CCC(N)=O)C(=O)O
